#.................................................
..................................................
..................................................
..................................................
..................................................
....#.............................................
.....#............................................
......#...........................................
.......#..........................................
.......#..........................................
........#.........................................
.........#........................................
..........#.......................................
..........##......................................
...........##.....................................
............##....................................
.............##...................................
.............###..................................
..............##..................................
...............##.................................
................##................................
................###...............................
.................###..............................
..................###.............................
...................###............................
...................####...........................
....................####..........................
.....................###..........................
......................###.........................
......................####........................
.......................####.......................
........................####......................
.........................####.....................
.........................#####....................
..........................#####...................
...........................#####..................
............................####..................
............................#####.................
.............................#####................
..............................#####...............
...............................#####..............
...............................######.............
................................######............
.................................######...........
..................................######..........
..................................######..........
...................................######.........
....................................######........
.....................................######.......
.....................................#######......