*#####*#########*#####*#####*###*#######**
#.....#.........#.....#.....#...#.......#*
*##.#.###.###.#.#.###.###.#.#.#.#####.#.#*
#...#...#.#...#...#.#...#.#...#.....#.#.#*
#.##*##.#.#.#######.###.#.#########.#.#.#*
#...#.#.#.#.#...#.....#...#.......#.#.#.#*
*##.#.#.###.#.#.#####.#####.#######.#.#.#*
#...#...#...#.#.....#.....#.........#.#.#*
#.###.###.###.#####.#.#.###.###########.#*
#.#...#...#.....#.....#.#...#.........#.#*
#.#.###.#.#.###.#.#######.#########.#.#.#*
#.#...#.#.#...#.#.#.....#.....#.....#...#*
#.###.###.#####.#.#.###.#####.#.####*##.#*
#...#.....#.....#.#.#.......#...#...#...#*
#.#.#######.#######.#.###########.#.#.##**
#.#...#.............#.#.........#.#...#.#*
#.###.#.#############.#.#######.#.#####.#*
#.#...#.#...........#.#.#...#...#...#...#*
*##.#####.#########.#.#.#.#.#.#####.#.#.#*
#...#...#...#.....#.#.....#.#.....#.#.#.#*
#.###.#.###.#.###.#.#######.#####.#.#.##**
#...#.#.....#.#.....#S#...#.#...#...#...#*
#.#.#.#######.#.#####.#.###.###.#####.#.#*
#.#.#...#...#.#.#.....#.......#...#...#.#*
#.#.###.###.#.###.#####.#####.#.#.#####.#*
#.#...#.....#.....#.....#...#.#.#...#...#*
#.#.#.#####.###########.#.#.#.#.###.#.#.#*
#.#.#.....#...........#.#.#.#...#.#...#.#*
*##.#.###############.###.#.#####.#####.#*
#...#.#.............#.#...#.....#.......#*
#.#####.###########.#.#.#######.###.####**
#.#.....#.........#.#...#.....#...#.#...#*
#.#.#####.#.###.###.#####.#.#####.#.###.#*
#.#.#X....#.#...#...#...#.#.......#.....#*
#.#.#######.#####.#.###.#.#############.#*
#.#.........#.....#.....#...#...#.....#.#*
#.#########.#.#####.#######.#.#.#.#.###.#*
#.....#.....#.#.....#.....#.#.#...#.....#*
#.#####.#####.#######.###.#.#.##########**
#...........#...........#...#...........#*
*###########*###########*###*###########**