#######..................................
#.....#..................................
#.....#..................................
#.....#..................................
#.....#..................................
#.....#..................................
#.....#.......................#####......
#.....#.......................#...#......
#.....#.......................#...#......
#.....#.......................#...#......
###########.................###########..
......#...#.................#.#...#...#..
......#######...........#######...#...#..
..........#.#...........#...#.....#...#..
..........#.#...........#...#.....#...#..
..........#.#...........#...#.....#...#..
..........#######.......#.#############..
............#...#.......#.#.#.....#......
............#############.#.#.....######^
................#.........#.#............
................#.....#######............
................#.....#...#..............
................#...#######..............
................#...#.#..................
................#...#.#..................
................#...#.#..................
..........#############..................
..........#.....#...#....................
..........#.....#####....................
..........#..............................
..........#######........................
................#........................
................#.#......................
................#.#......................
................#.#......................
................#.#......................
................#######..................
..................#...#..................
..................###########............
......................#.....#............
......................#.....#............
......................#.....#............
......................#.....#............
......................#.....#............
......................#.....#............
......................#.....#............
......................#.....#............
......................#.....#............
......................#######............